10 10 3 1 1 1 1 1 1 3 1 1 
1 3 1 1 1 3 3 3 1 1 
1 1 1 1 1 1 3 3 1 1 
1 1 6 0 6 3 3 1 1 1 
1 6 6 6 6 3 3 3 1 1 
1 1 1 6 6 3 3 3 1 1 
1 1 1 1 3 3 1 1 1 1 
3 1 1 3 1 1 1 1 1 1 
1 1 1 3 1 1 1 1 3 1 
1 1 3 3 1 1 1 1 3 1 
0 